atp14_yeast  (pp)  atp8_yeast	physical	1
atp18_yeast (pp) atpg_yeast	physical	1
atp7_yeast (pp) atpo_yeast	physical	1
atp14_yeast (pp) atp9_yeast	physical	1
atp14_yeast (pp) atpk_yeast	physical	1
atp14_yeast (pp) atpb_yeast	physical|affinity	2
atp8_yeast (pp) atpb_yeast	physical	1
atp6_yeast (pp) atpf_yeast	physical	1
atp8_yeast (pp) atp9_yeast	physical	1
atp14_yeast (pp) atp7_yeast	physical	1
atp7_yeast (pp) atpa_yeast	physical	1
atp8_yeast (pp) atpa_yeast	physical	1
atpk_yeast (pp) atpo_yeast	physical	1
atp6_yeast (pp) atpg_yeast	physical	1
atp6_yeast (pp) atp9_yeast	physical	1
atp14_yeast (pp) atp18_yeast	physical	1
atp18_yeast (pp) atpa_yeast	physical	1
atp14_yeast (pp) atpo_yeast	physical	1
atp14_yeast (pp) atp6_yeast	physical	1
atpb_yeast (pp) atpo_yeast	affinity	1
atpd_yeast (pp) atpo_yeast	physical	1
atpg_yeast (pp) atpk_yeast	physical	1
atp14_yeast (pp) atpg_yeast	physical	1
atp9_yeast (pp) atpf_yeast	physical	1
atp18_yeast (pp) atp5e_yeast	physical	1
atp9_yeast (pp) atpd_yeast	physical	1
atp5e_yeast (pp) atp9_yeast	physical	1
atp6_yeast (pp) atpd_yeast	physical	1
atpb_yeast (pp) atpg_yeast	physical	1
atp6_yeast (pp) atp8_yeast	physical	1
atp6_yeast (pp) atp7_yeast	physical	1
atp18_yeast (pp) atpb_yeast	physical|affinity	2
atp18_yeast (pp) atp9_yeast	physical	1
atp9_yeast (pp) atpa_yeast	physical	1
atpa_yeast (pp) atpo_yeast	physical	1
atp18_yeast (pp) atp7_yeast	physical	1
atpd_yeast (pp) atpk_yeast	physical	1
atpa_yeast (pp) atpb_yeast	physical|affinity	2
atp18_yeast (pp) atp6_yeast	physical	1
atp8_yeast (pp) atpf_yeast	physical	1
atpb_yeast (pp) atpf_yeast	physical	1
atpb_yeast (pp) atpk_yeast	physical	1
atpb_yeast (pp) atpo_yeast	physical	1
atp6_yeast (pp) atpa_yeast	physical	1
atp7_yeast (pp) atpg_yeast	physical	1
atp5e_yeast (pp) atp8_yeast	physical	1
atp7_yeast (pp) atp8_yeast	physical	1
atp14_yeast (pp) atpd_yeast	physical	1
atp5e_yeast (pp) atp6_yeast	physical	1
atp5e_yeast (pp) atp7_yeast	physical	1
atpd_yeast (pp) atpf_yeast	physical	1
atpb_yeast (pp) atpg_yeast	affinity	1
atp5e_yeast (pp) atpd_yeast	physical	1
atp9_yeast (pp) atpo_yeast	physical	1
atp8_yeast (pp) atpg_yeast	physical	1
atp18_yeast (pp) atpk_yeast	physical	1
atp14_yeast (pp) atpa_yeast	physical	1
atpf_yeast (pp) atpk_yeast	physical	1
atp7_yeast (pp) atpf_yeast	physical	1
atpa_yeast (pp) atpd_yeast	physical	1
atp8_yeast (pp) atpk_yeast	physical	1
atp5e_yeast (pp) atpb_yeast	physical|affinity	2
atpf_yeast (pp) atpg_yeast	physical	1
atpf_yeast (pp) atpo_yeast	physical	1
atp5e_yeast (pp) atpf_yeast	physical	1
atp5e_yeast (pp) atpk_yeast	physical	1
atp9_yeast (pp) atpb_yeast	physical	1
atp18_yeast (pp) atpo_yeast	physical	1
atp6_yeast (pp) atpo_yeast	physical	1
atpb_yeast (pp) atpd_yeast	affinity	1
atpa_yeast (pp) atpk_yeast	physical	1
atp18_yeast (pp) atpf_yeast	physical	1
atp8_yeast (pp) atpd_yeast	physical	1
atp14_yeast (pp) atpf_yeast	physical	1
atp7_yeast (pp) atp9_yeast	physical	1
atp6_yeast (pp) atpb_yeast	physical	1
atpd_yeast (pp) atpg_yeast	physical	1
atpg_yeast (pp) atpo_yeast	physical	1
atp18_yeast (pp) atp8_yeast	physical	1
atp5e_yeast (pp) atpg_yeast	physical	1
atp7_yeast (pp) atpk_yeast	physical	1
atp5e_yeast (pp) atpa_yeast	physical	1
atp5e_yeast (pp) atpo_yeast	physical	1
atpb_yeast (pp) atpd_yeast	physical	1
atp14_yeast (pp) atp5e_yeast	physical	1
atp7_yeast (pp) atpd_yeast	physical	1
atp7_yeast (pp) atpb_yeast	physical|affinity	2
atp9_yeast (pp) atpg_yeast	physical	1
atp18_yeast (pp) atpd_yeast	physical	1
atpa_yeast (pp) atpg_yeast	physical	1
atp6_yeast (pp) atpk_yeast	physical	1
atpb_yeast (pp) atpf_yeast	affinity	1
atpb_yeast (pp) atpk_yeast	affinity	1
atp9_yeast (pp) atpk_yeast	physical	1
atp8_yeast (pp) atpo_yeast	physical	1
atpa_yeast (pp) atpf_yeast	physical	1
